OOOXXOXO
OOOX!OXO
OXXXOOOX
OXXXOOXO
OOOOOOOX
OXOXOXOX
XOOXOOOX
OOXXOOOO